Gawader	Kappar
Kappar	Turbat
Turbat	Sami
Sami	Hoshab
Hoshab	Panjgur
Panjgur	Nag
Nag	Basima
Basima	Surab
Surab	Kalat
Kalat	Khaliqabad
Khaliqabad	Mastung
Mastung	Lakpass
Lakpass	Quetta
Quetta	Kuchlak
Kuchlak	Kanozai
Kanozai	MuslimBagh
MuslimBagh	QillaSaifullah
QillaSaifullah	Zhob
Zhob	DhanaSar
DhanaSar	Darazinda
Darzinda	Kulachi
Kulachi	DIKhan
DIKhan	Bhakkar
Bhakkar	Mankera
Mankera	BaghriSargana
BaghriSargana	Jhang
Jhang	Gojra
Gojra	Burhan
Burhan	Haripur
Haripur	Abbotabad
Abbotabad	Mansehra
Mansehra	Sazin
Sazin	RaikotBridge
RaikotBridge	Gilgit
Gilgit	Khunjerab
Basima	Rango
Rango	Khuzdar
Khuzdar	Shahdadkot
Shahdadkot	Ratodero
Ratodero	Shikarpur
Shikarpur	Sukkur
Shahdadkot	DeraAllahyarKhan
DeraAllahyarKhan	DGKhan
DGKhan	DaryaKhan
DaryaKhan	DIKhan
Gawader	Karachi
Karachi	Jamshoro
Jamshoro	Hyderabad
Hyderabad	Bhitshah
Bhitshah	Maatyari
Maatyari	Hala
Hala	Saeedabad
Saeedabad	Sakrand
Sakrand	Nawabshah
Nawabshah	Dadu
Dadu	Moro
Moro	Miranpur
Miranpur	Rasoolpur
Rasoolpur	KotBanglo
KotBanglo	Khairpur
Khairpur	Sukkur
Sukkur	Sangi
Sangi	Rohri
Rohri	Panuaqil
Panuaqil	HussainKalwar
HussainKalwar	Gamro
Gamro	Ghotki
Ghotki	Daharki
Daharki	Ubauro
Ubauro	Sadiqabad
Sadiqabad	RahimYarKhan
RahimYarKhan	Multan
Multan	Fatehpur
Fatehpur	Khanewal
Khanewal	AbdulHakeem
AbdulHakeem	Faisalabad
Faisalabad	Burhan
Faisalabad	Lahore
Lahore	KankaSahab
KankaSahab	Sargodha
Sargodha	PindiBahauddin
PindiBahauddin	Chakwal
Chakwal	Burhan
Burhan	Peshawar
Basima	Rango
Rango	Khuzdar
Khuzdar	Shahdadkot
Shahdadkot	Ratodero
Ratodero	Shikarpur
Shikarpur	Sukkur
AbdulHakeem	MianChannun
MianChannun	ChichaWatni
ChichaWatni	Sahiwal
Sahiwal	Okara
Okara	Pattoti
Pattoti	BaiPhero
BaiPhero	Lahore
